#        	(mj) dict 10 - meine Karteikästen übernehmen
#			ab dem Rautezeichen(#) wird eine Zeile nicht mehr als Vokabel gelesen
#         	=    trennt verschiedene Sprachen
#         	,    trennt Worte mit gleicher oder ähnlicher Bedeutung
#         	;    trennt Worte mit anderer Bedeutung (siehe compound oder groom)
#			()   umschließt eine weitere Bedeutung bzw. eine Beschreibung
#  			[]   umschließt Lautschrift
#  			""   Phrase
#			??   überprüfen
#			{}   noch keine Bedeutung


deceive = täuschen
assert = behaupten (im Sinne von sich durchsetzen), geltend machen, durchsetzen
deprive (s.o. on s.th.) = jem. um etwas bringen
device = Vorrichtung, Gerät, Erfindung
devise = entwickeln, ausdenken, ersinnen
evolve = entwickeln
purge = säubern
distort = verzerren
gratitude = Dankbarkeit
thus = folglich, somit
ermu~tigen~tern = encourage
lurch = schlingern
redeem = einlösen
ridicule(s) = Spott, lächerlich
appreciate = schätzen, würdigen
falter = stolpern; stocken (Stimme)
compound = zusammensetzen; Lager, Gefängnishof, Gehege
premature = vorzeitig, verfrüht
impact = Anprall; (Ein)Wirkung
composure = (Gemüts)-Fassung
concern(d) = betreffen; besorgt
dependable, reliable = zuverlässig, verlässlich
harassed = schikaniert
slope = Hange; Gefälle, Neigung
frail = gebrechlich
severe [si’via(r)] = ernst, streng
tender = zart
?? abandon = verlassen, sich trennen
?? forsake = verlassen
agility = Beweglichkeit
enable = befähigen
according = übereinstimmen, gemäß
event = Ereignis
recreation = Erholung
possession = Besitz
treason = Landesverrat
assessment = Einschätzung
neglect [ni’glekt] = vernachlässigen
alter = (ver)ändern
leisure = Ruhe; Freizeit
feature = Merkmal; Attraktion
estimate, assess = abschätzen
demand = fordern, verlangen
rapture = entrücken, Verzückung
common = gemeinsam
restrain = ab-zurückhalten, in Schranken halten; beeinträchtigen
grant(ing) = Bewillig-en/ung
invoke = aufrufen, ?? erflehen
convene [kan’vi:n] = versammeln
notorious = berüchtigt
suspense [saspens] = (nervl.) Spannung
perspire = schwitzen
perspiration = Schweiß
demanding = anspruchsvoll
claim = beanspruchen; behaupten
treachery = Verrat
retrieve =zurückholen; wettmachen, wieder gutmachen
endeavour [in´deva] = bemüht, bestrebt; Bemühung, Bestrebung
persecution = Verfolgung
humiliation = Demütigung
fade (fade in, fade out) = (ver)-welken -blassen, auflösen, nachlassen, schwinden,
affect = beeinflussen
culprit = Täter
modesty = Bescheidenheit
advance = vor-rücken, -schieben, -verlegen
entire = ganz, gesamt
be astonished = erstaunt sein
supposed = angeblich
property = Eigentum
tilt = kippen
pase up and down = auf und ab gehen
curse = Fluch
a slap in the face = ein Schlag ins Gesicht
exterminate = vertilgen, ausrotten
facility = Leichtigkeit, Mühelosigkeit; Gelegenheit (Koch)??; Einrichtung, Anlage
huddle together = zusammendrängen
encounter = treffen, stoßen auf; Begegnung, Gefecht
pagan = Heide
eternity = Ewigkeit
ascribe = zuschreiben, beimessen
divine = göttlich
admission = Ein-tritt,-lass, Zutritt
apply = auflegen, auftragen, anbringen, anwenden; zutreffen
extent = Ausdehnung, Ausmaß
exclaim = (aus)rufen
dispatch = (ab)senden, (ab)schicken ??
conscious = Bewußtsein, im Klaren sein
providence = Vorhersehung
occasionally = gelegentlich, hin u. wieder
intimidate = einschüchtern
reveal = den Blick freigeben, zeigen; enthüllen, aufdecken
firm = fest, hart, stabil
levitate = schweben
merge = fusionieren, verschmelzen
slash = aufschlitzen; drastisch kürzen
filth = Dreck, Schmutz (stärker)
gentle = sanft
capture = fangen
groom = Pferdeknecht, Stallbursche; Bräutigam
bachelor = Junggeselle
development = Entwicklung
confess = bekennen, (ein)gestehen
submerge = eintauchen
cause = Ursache
release = (los,ent,frei)lassen
humility = Demut
with rapt attention = mit gespannter Aufmerksamkeit
casual = beiläufig
advise = raten, empfehlen
advice = Ratschlag
opaque = 
preceding =
arbitrary =
faith = Glaube
loose [lu:s] = lose, locker
destitute = mittellos, völlig verarmt
dwell = wohnen
instantly = sofort
fondness = Zärtlichkeit, Zuneigung
acknowledgement = Anerkennung
annoy = ärgern
have a slash = schiffen gehen
stench = Gestank
frantic = ausser sich, rasend
compell = zwingen, nötigen
dense = dicht (Nebel, Wald; blöd)
sting = stechen
dusk, dawn = (Abend)Dämmerung, (Morgen)Dämmerung
ability = Fähigkeit
resurrection = Auferstehung
lumber = Bauholz, Nutzholz
slender = schlank
condemn = verdammen, verurteilen
humble = demütig
consider = bedenken, beachten
defiance = Trotz, Missachtung
flaw = Makel
ambiguous = zweideutig, mehrdeutig
contagious [konteeidschos] = ansteckend
peculiar, strange, odd = seltsam, merkwürdig
dwarf = Zwerg
to dwarf = in den Schatten stellen
detain = festnehmen; abhalten ?
determine, destine ? = bestimmen
lure = ködern
ambig, ambigue = selten
considerably = beträchtlich
respite = Aufschub, aufschieben
arbitrarily = willkürlich
coincident = gleichzeitig; übereinstimmend ?
obnoxious = widerlich
disguise = tarnen, verschleiern
deploy = aufbieten; anwenden, nutzen; formieren
attend = Kranke pflegen bzw behandeln; begleiten; (Schule)besuchen, teilnehmen
chilled = kühlte ab
devastating = verheerend
allegedly = angeblich
accelerat(e|or) = beschleunigen | Gaspedal
commit = begehen; übergeben
casket [kâsket] = Sarg
aperture = Öffnung, Durchbruch
hermit = Einsiedler
jutted = herausragen (Felsen)
swift = schnell
mourne = trauern
resiliance = Widerstandsfähigkeit
relate = erzählen, berichten
substitute = ersetzen, austauschen 
devise = entwickeln; ausdenken, ersinnen
evolve = entwickeln
device = Vorrichtung, Gerät; Erfindung; (Einfall, Trick?) ?
deprive s.o on s.th. = jem. um etwas bringen
assert = behaupten, geltend machen
deceive = täuschen
purge = säubern
distort = verzerren
gratitude = Dankbarkeit
thus = folglich, somit
encourage = ermutigen, ermuntern
lattis [lætis] = Gitter, vergittern ?
goad(ing) = anstacheln
commitment = Übergabe; Verpflichtung
alert = Wachsamkeit, Aufmerksamkeit
deliberate = überlegt, bewußt, absichtlich
defy = trotzen (Gefahr)
lassie = Mädchen; Freundin, Schatz
oddment = Überbleibsel, Rest
abound = reichlich vorhanden sein
tangle = verflechten, verwirren
enchant = verzaubern (Magie); bezaubern, entzücken
straggle = bummeln, herumstreunen
Missbrauch = abuse
preseption = Wahrnehmung
destine [destin] = bestimmen
despite = trotz (trotz irgendwas)
sulk = schmollen
capable = fähig, talentiert
disgrace = Schande
submission = Einreichung
anguish = Qual, Pein
tenderness, fondness = Zärtlichkeit
affection = Zuneigung
lurk = lauern(Gefahr)
nevertheless = trotzdem
supplement = Nachtrag, Ergänzung, Anhang
challange = Herausforderung
funish = einrichten (Wng)
indipendent = selbständig
posh = piekfein, feudal
(over)strain = 2 anspannen; 1 (über)anstrengen 
idle = untätig, müßig, ruhig, still; faul, träge; stillstehend (außer Betrieb); nutzlos, sinnlos
idle gossip = leeres Geschwätz
assume, suppose = vermuten
comperativ = vergleichend; verhältnismäßig, relativ
achievement = Errungenschaft; Leistung
betrayal = Verrat
pungent [pandschænt] = scharf (Gemschack, Geruch)
drench = durchnässen
vicious [vischæs] = brutal
aim = zielen; beabsichtigen; streben
armpits = Achselhöhlen
scarce = selten
bear = ertragen, aushalten
? beckon = zurückwinken
belligerent = streitlustig
booth = Bude, Messestand, Stand, Zelle
booze = saufen, Schnaps; (passt auch zu booth)
brass = Ärger, Wut
clue = Anhaltspunkt, Hinweis
to oblige sb. to do sth. = jem. zu etwas verpflichten
compassion = Mitleid
concussion [?] = Erschütterung, Schütteln
concise [konsais?] = kurz, knapp
convictions	= Überzeugungen; Vorstrafen
cot	= Hütte
?cowardice = Feigheit
crickets = Grillen (Viechers)
crest = Bergrücken; Büschel
decoy = Köder (...bird) ?
defiant = Ungehorsam; tollkühner Wiederstand
indetermined = unbestimmt
discern = wahrnehmen
expelled = ausgestoßen
fedora = weicher Filzhut
ferocious = grausam, bösartig; grimmig
fragrant = duftend
frown = Stirnrunzeln
genuine = echt, wirklich
hazard = riskieren, Risiko
hollow = hohl, Höhle
hostility = Anfeindung, Feindschaft, Feindseligkeit	
hum = summen, brummen
incident = Begebenheit, Ereignis, Vorfall, Zwischenfall
incinerated = eingeäschert
inevitable = unvermeidlich
involuntarily = unfreiwillig, unfreiwillige	
irate = wütend, zornig	
jamb = (Tür-)Pfosten
?aw = Kiefer
juniper [dʒuːnipər] = Wacholder
lingered = fortbestehen; verweilen
loom = auftauchen, heraufziehen
mere = bloß, nur
mourn = trauern	
mug = Becher, Krug; Visage
muttered = murmelte
nexus = Zusammenhang, Verbindung, Verflechtung
obstinacy [?] = Eigensinn, Sturheit	
ordeal [?] = Feuer- Geduldsprobe, Prüfung
pang = Schmerz, Stechen
pasture = Viehweide, Weide, Weideland
peer = spähen
perpetuate = aufrechterhalten
plowed = pflügte	
provide = bereitstellen, ..  ?
quilt = Steppdecke
recess [rises ?] = Aussparung, Pause, Unterbrechung
reconciled = ausgesöhnt, versöhnte
reprieve = verschonen
serenity = Ruhe, Gelassenheit, Abgeklärtheit , Heiterkeit, Klarheit
sheer = rein
sinister = unheimlich
spawn = hervorbringen, laichen; Ausgeburt, Brut
stack = Stapel
stains = befleckt; Flecken
stark = stark; völlig
subsiding = sinkend
summit = Gipfel
surging = wogend
tenant =  = Mieter
threshold = Schwelle, Schwellwert
torrent = Flut
traitorous = verräterisch
uprising = Aufstand
veil = Schleier
verbatim [vəːbeitim] = wörtlich
wince [?] = zusammenzucken
contrive = ausdenken, erfinden
infer = schlussfolgern
perimeter = Umfang
Intermediate = 
bbb = bbbb
aaa = aaaa
ZZZ = ZZZ
zzz = zzz
ZZZ = ZZZ











